2	5	2	5	2	5	2	5	2	5	2	5	2	5	2	5	2	5	2	5	2	5	2	5	2	5	2	5	2	5
5	2	5	2	5	2	5	2	5	2	5	2	5	2	5	2	5	2	5	2	5	2	5	2	5	2	5	2	5	2
2	5	2	5	2	5	2	5	2	5	2	5	2	5	2	5	2	5	2	5	2	5	2	5	2	5	2	5	2	5
5	2	5	2	0	2	0	2	0	2	0	2	0	2	0	2	0	2	0	2	0	2	5	2	0	2	0	2	5	2
2	5	2	0	2	0	2	0	2	0	2	0	2	0	2	0	2	0	2	0	2	0	2	0	2	0	2	5	2	5
5	2	5	2	0	2	0	2	0	2	0	2	0	2	0	2	0	2	0	2	0	2	5	2	0	2	0	2	5	2
2	5	2	0	2	0	2	0	2	0	2	0	2	0	2	0	2	0	2	0	2	0	2	0	2	0	2	5	2	5
5	2	5	2	0	2	0	2	5	2	5	2	5	2	5	2	5	2	0	2	0	2	5	2	0	2	0	2	5	2
2	5	2	0	2	0	2	0	2	0	2	0	2	0	2	0	2	5	2	0	2	0	2	0	2	0	2	5	2	5
5	2	5	2	0	2	0	2	0	2	0	2	5	2	0	2	0	2	0	2	0	2	0	2	0	2	0	2	5	2
2	5	2	0	2	0	2	0	2	0	2	0	2	0	2	0	2	5	2	0	2	0	2	0	2	0	2	5	2	5
5	2	5	2	0	2	0	2	0	2	0	2	5	2	0	2	0	2	0	2	0	2	0	2	0	2	0	2	5	2
2	5	2	0	2	0	2	5	2	0	2	0	2	0	2	0	2	5	2	5	2	5	2	0	2	0	2	5	2	5
5	2	5	2	0	2	0	2	0	2	0	2	5	2	0	2	0	2	0	2	0	2	0	2	0	2	0	2	5	2
2	5	2	0	2	0	2	5	2	0	2	0	2	0	2	0	2	0	2	0	2	0	2	0	2	0	2	5	2	5
5	2	5	2	0	2	0	2	0	2	0	2	5	2	0	2	0	2	0	2	0	2	0	2	0	2	0	2	5	2
2	5	2	0	2	0	2	5	2	0	2	0	2	0	2	0	2	0	2	0	2	0	2	0	2	0	2	5	2	5
5	2	5	2	5	2	5	2	0	2	0	2	5	2	0	2	0	2	5	2	5	2	5	2	5	2	5	2	5	2
2	5	2	0	2	0	2	0	2	0	2	0	2	0	2	0	2	0	2	0	2	0	2	0	2	0	2	5	2	5
5	2	5	2	0	2	0	2	0	2	0	2	5	2	0	2	0	2	0	2	0	2	0	2	0	2	0	2	5	2
2	5	2	0	2	0	2	0	2	0	2	0	2	0	2	0	2	0	2	0	2	0	2	0	2	0	2	5	2	5
5	2	5	2	0	2	0	2	0	2	0	2	5	2	0	2	0	2	0	2	0	2	0	2	0	2	0	2	5	2
2	5	2	0	2	0	2	5	2	0	2	0	2	5	2	5	2	5	2	5	2	5	2	0	2	0	2	5	2	5
5	2	5	2	0	2	0	2	0	2	0	2	5	2	0	2	0	2	0	2	0	2	5	2	0	2	0	2	5	2
2	5	2	0	2	0	2	5	2	0	2	0	2	0	2	0	2	0	2	0	2	0	2	0	2	0	2	5	2	5
5	2	5	2	0	2	0	2	0	2	0	2	5	2	0	2	0	2	0	2	0	2	5	2	0	2	0	2	5	2
2	5	2	0	2	0	2	5	2	0	2	0	2	0	2	0	2	0	2	0	2	0	2	0	2	0	2	5	2	5
5	2	5	2	0	2	0	2	5	2	5	2	5	2	0	2	0	2	0	2	0	2	5	2	5	2	5	2	5	2
2	5	2	0	2	0	2	5	2	0	2	0	2	0	2	0	2	5	2	0	2	0	2	0	2	0	2	5	2	5
5	2	5	2	0	2	0	2	0	2	0	2	0	2	0	2	0	2	0	2	0	2	0	2	0	2	0	2	5	2
2	5	2	0	2	0	2	5	2	0	2	0	2	0	2	0	2	5	2	0	2	0	2	0	2	0	2	5	2	5
5	2	5	2	0	2	0	2	0	2	0	2	0	2	0	2	0	2	0	2	0	2	0	2	0	2	0	2	5	2
2	5	2	0	2	0	2	5	2	0	2	0	2	5	2	5	2	5	2	5	2	5	2	0	2	0	2	5	2	5
5	2	5	2	0	2	0	2	0	2	0	2	5	2	0	2	0	2	0	2	0	2	0	2	0	2	0	2	5	2
2	5	2	0	2	0	2	0	2	0	2	0	2	0	2	0	2	0	2	0	2	0	2	0	2	0	2	5	2	5
5	2	5	2	0	2	0	2	0	2	0	2	5	2	0	2	0	2	0	2	0	2	0	2	0	2	0	2	5	2
2	5	2	0	2	0	2	0	2	0	2	0	2	0	2	0	2	0	2	0	2	0	2	0	2	0	2	5	2	5
5	2	5	2	0	2	0	2	5	2	5	2	5	2	0	2	0	2	5	2	5	2	5	2	0	2	0	2	5	2
2	5	2	0	2	0	2	5	2	0	2	0	2	0	2	0	2	5	2	0	2	0	2	0	2	0	2	5	2	5
5	2	5	2	0	2	0	2	0	2	0	2	0	2	0	2	0	2	0	2	0	2	5	2	0	2	0	2	5	2
2	5	2	0	2	0	2	5	2	0	2	0	2	0	2	0	2	5	2	0	2	0	2	0	2	0	2	5	2	5
5	2	5	2	0	2	0	2	0	2	0	2	0	2	0	2	0	2	0	2	0	2	5	2	0	2	0	2	5	2
2	5	2	5	2	5	2	5	2	0	2	0	2	5	2	5	2	5	2	0	2	0	2	0	2	0	2	5	2	5
5	2	5	2	0	2	0	2	0	2	0	2	5	2	0	2	0	2	0	2	0	2	5	2	0	2	0	2	5	2
2	5	2	0	2	0	2	0	2	0	2	0	2	0	2	0	2	0	2	0	2	0	2	0	2	0	2	5	2	5
5	2	5	2	0	2	0	2	0	2	0	2	5	2	0	2	0	2	0	2	0	2	5	2	0	2	0	2	5	2
2	5	2	0	2	0	2	0	2	0	2	0	2	0	2	0	2	0	2	0	2	0	2	0	2	0	2	5	2	5
5	2	5	2	0	2	0	2	5	2	5	2	5	2	0	2	0	2	5	2	5	2	5	2	0	2	0	2	5	2
2	5	2	0	2	0	2	5	2	0	2	0	2	0	2	0	2	5	2	0	2	0	2	0	2	0	2	5	2	5
5	2	5	2	0	2	0	2	0	2	0	2	0	2	0	2	0	2	0	2	0	2	0	2	0	2	0	2	5	2
2	5	2	0	2	0	2	5	2	0	2	0	2	0	2	0	2	5	2	0	2	0	2	0	2	0	2	5	2	5
5	2	5	2	0	2	0	2	0	2	0	2	0	2	0	2	0	2	0	2	0	2	0	2	0	2	0	2	5	2
2	5	2	0	2	0	2	5	2	0	2	0	2	5	2	5	2	5	2	0	2	0	2	5	2	5	2	5	2	5
5	2	5	2	0	2	0	2	0	2	0	2	0	2	0	2	0	2	0	2	0	2	0	2	0	2	0	2	5	2
2	5	2	0	2	0	2	5	2	0	2	0	2	0	2	0	2	0	2	0	2	0	2	0	2	0	2	5	2	5
5	2	5	2	0	2	0	2	0	2	0	2	0	2	0	2	0	2	0	2	0	2	0	2	0	2	0	2	5	2
2	5	2	0	2	0	2	5	2	0	2	0	2	0	2	0	2	0	2	0	2	0	2	0	2	0	2	5	2	5
5	2	5	2	5	2	5	2	5	2	5	2	5	2	5	2	5	2	5	2	5	2	5	2	5	2	5	2	5	2
2	5	2	5	2	5	2	5	2	5	2	5	2	5	2	5	2	5	2	5	2	5	2	5	2	5	2	5	2	5
5	2	5	2	5	2	5	2	5	2	5	2	5	2	5	2	5	2	5	2	5	2	5	2	5	2	5	2	5	2
